R    400 400
NO      ./textures/NO.xpm
SO ./textures/SO.xpm
   WE       ./textures/WE.xpm
EA    ./textures/EA.xpm
        S ./textures/S.xpm
      F 00,       153,    15

C    255,255,       255



        1111111111111111111111111
        1000000000000000000000001
        1100000000000000000000001
        1000000000000000000000001
111111111000000000000000000000001
100000000000000000000000000001111
10000000000000N100000200000011
10000020000000000000000000001
11111111111111111111111111111
11111111111111111111111111111
10000000000000000000000000001
10000000002000000000020000001
10000000000000000001010000001
11000001110101011111011110101
11110111 1110121 101111010001
11111111 1111111 111111111111